#####  ##  ##  ##  ##  ##  #####
#                              #
#                              #
#                              #
#   ##        ####        ##   #
    #       # #            #    
            # #                 
#             #  ##            #
#                #             #
                                
                                
#                              #
#                        ##    #
       #       #                
    #  ##      #        ####    
#   #          ####        #   #
#   #        ####          #   #
    ####        #      ##  #    
                #       #       
#    ##                        #
#                              #
                                
                                
#             #                #
#            ##  #             #
                 # #            
    #            # #       #    
#   ##        ####        ##   #
#                              #
#                              #
#                              #
#####  ##  ##  ##  ##  ##  #####