###  ##  ##  ##  ##  ###
#                      #
#                      #
   ##              ##   
   #                #   
#                      #
#     #          #     #
                        
                        
#          #           #
#          #           #
           ####         
         ####           
#           #          #
#           #          #
                        
                        
#     #          #     #
#                      #
   #                #   
   ##              ##   
#                      #
#                      #
###  ##  ##  ##  ##  ###